##########
#   @    #
#        #
#   $    #
#        #
#        #
#   .    #
#        #
#        #
##########