##########
#@ $    .#
####### ##
#.    $ ##
## #######
## $    .#
###### ###
###### ###
#.   $   #
##########