##########
#@       #
####   ###
#  $  $  #
#   ##   #
######   #
######   #
#.    .  #
######   #
##########