########
#   #  #
# #.$  #
#   $  #
#####  #
## .  @#
##     #
########