********
*   *  *
* *GB  *
*   B  *
*****  *
** G  P*
**     *
********