#######
#    ##
# @   #
#  $  #
#   # #
# #$# #
##.  .#
#######
