#######
##  ###
##  $ #
##. . #
#  @$ #
#   ###
#######