*******
**  ***
**  B *
**G G *
*  PB *
*   ***
*******