******
**  **
*PB **
**B **
** B *
*GB  *
*GG G*
******