######
##  ##
#@$ ##
##$ ##
## $ #
#.$  #
#.. .#
######