###########
#### ######
###  ###  #
## $      #
#   @  #  #
### $###  #
###  # .  #
### ##.# ##
##      ###
##     ####
###########