***********
**** ******
***  ***  *
** B      *
*   P  *  *
*** B***  *
***  * G  *
*** **G* **
**      ***
**     ****
***********