********
*** GGP*
*** BB *
**** ***
**** ***
**** ***
**** ***
*    ***
* *   **
*   * **
***   **
********
