**********
*   P    *
*        *
*   B    *
*        *
*        *
*   G    *
*        *
*        *
**********