#########
#  ######
#  ######
#  ######
#  ######
#.$$ $@ #
#  . .  #
#  ######
#########