*********
*  ******
*  ******
*  ******
*  ******
*GBB BP *
*  G G  *
*  ******
*********