**********
*P B    G*
******* **
*G    B **
** *******
** B    G*
****** ***
****** ***
*G   B   *
**********