*******
*    **
* P   *
*  B  *
*   * *
* *B* *
**G  G*
*******
